...3.3333...
...X..3.....
...####..X..
0..#.G......
...#3.33....
...#XXXX....
...#........
...#....X...
33X#........
...#.X......
............
...X........